//MAP CONVERTED BY dmm2tgm.py THIS HEADER COMMENT PREVENTS RECONVERSION, DO NOT REMOVE
"aW" = (
/obj/structure/curtain/cloth/fancy,
/obj/structure/table/wood,
/obj/item/clothing/gloves/color/captain,
/obj/item/clothing/under/rank/command/captain/parade,
/obj/item/clothing/suit/armor/vest/capcarapace/alt,
/obj/item/clothing/neck/cloak/cap,
/obj/item/stamp/captain,
/turf/open/floor/carpet/red,
/area/ruin/unpowered/ash_walkers)
"aX" = (
/turf/open/floor/vault,
/area/lavaland/surface/outdoors)
"bh" = (
/obj/structure/table/wood/fancy,
/turf/open/floor/carpet/red,
/area/ruin/unpowered/ash_walkers)
"by" = (
/obj/structure/railing/corner{
	dir = 4
	},
/turf/open/floor/vault,
/area/lavaland/surface/outdoors)
"bR" = (
/obj/structure/bed,
/obj/item/bedsheet/chaplain,
/obj/effect/mob_spawn/human/ash_walker,
/turf/open/floor/vault,
/area/ruin/unpowered/ash_walkers)
"cq" = (
/obj/structure/chair/wood{
	dir = 4
	},
/turf/open/floor/carpet/red,
/area/ruin/unpowered/ash_walkers)
"cR" = (
/obj/structure/table/wood/fancy,
/obj/item/clothing/neck/cloak/head_of_personnel,
/obj/item/clothing/head/hopcap{
	icon = 'icons/obj/clothing/hats.dmi';
	mob_overlay_icon = 'icons/mob/clothing/head.dmi'
	},
/obj/item/storage/belt/sabre,
/turf/open/floor/carpet/red,
/area/ruin/unpowered/ash_walkers)
"dw" = (
/obj/structure/bed,
/obj/item/bedsheet/medical,
/obj/machinery/iv_drip,
/turf/open/floor/vault,
/area/ruin/unpowered/ash_walkers)
"dT" = (
/obj/machinery/button/door{
	id = "cell3";
	name = "Cell 3 lock";
	normaldoorcontrol = 1;
	pixel_x = 25;
	specialfunctions = 4
	},
/obj/machinery/button/door{
	id = "cell1";
	name = "Cell 1 lock";
	normaldoorcontrol = 1;
	pixel_x = -25;
	specialfunctions = 4
	},
/turf/open/floor/vault,
/area/ruin/unpowered/ash_walkers)
"ey" = (
/turf/open/floor/plating/asteroid{
	initial_gas_mix = "LAVALAND_ATMOS"
	},
/area/lavaland/surface/outdoors)
"fg" = (
/obj/structure/shuttle/engine/propulsion/burst{
	dir = 4
	},
/turf/open/floor/plating,
/area/ruin/unpowered/ash_walkers)
"fS" = (
/obj/structure/table/wood,
/obj/item/flashlight/flare/torch,
/turf/open/floor/vault,
/area/ruin/unpowered/ash_walkers)
"fU" = (
/obj/structure/table/wood,
/obj/item/clothing/gloves/color/yellow,
/obj/item/clothing/head/hardhat,
/turf/open/floor/vault,
/area/ruin/unpowered/ash_walkers)
"gw" = (
/obj/structure/bed,
/obj/item/bedsheet/chaplain,
/obj/effect/mob_spawn/human/ash_walker,
/obj/effect/mob_spawn/human/ash_walker,
/turf/open/floor/vault,
/area/ruin/unpowered/ash_walkers)
"gC" = (
/turf/open/floor/plating/asteroid/basalt/lava_land_surface,
/area/lavaland/surface/outdoors)
"gL" = (
/obj/structure/chair/pew/right,
/turf/open/floor/vault,
/area/ruin/unpowered/ash_walkers)
"hl" = (
/obj/structure/railing/corner{
	dir = 1
	},
/turf/open/floor/vault,
/area/lavaland/surface/outdoors)
"hv" = (
/turf/closed/wall/mineral/iron,
/area/ruin/unpowered/ash_walkers)
"iv" = (
/obj/structure/shuttle/engine/heater{
	dir = 4
	},
/obj/structure/window/reinforced/spawner{
	dir = 8
	},
/turf/open/floor/plating,
/area/ruin/unpowered/ash_walkers)
"iT" = (
/obj/machinery/door/poddoor/shutters{
	id = 'ashcastle'
	},
/turf/open/floor/vault,
/area/ruin/unpowered/ash_walkers)
"iZ" = (
/obj/effect/mapping_helpers/no_lava,
/turf/open/floor/plating/asteroid/basalt/lava_land_surface,
/area/lavaland/surface/outdoors)
"jy" = (
/obj/structure/rack,
/turf/open/floor/vault,
/area/ruin/unpowered/ash_walkers)
"jQ" = (
/obj/structure/curtain/cloth/fancy,
/obj/structure/table/wood,
/obj/item/flashlight/lamp/green,
/turf/open/floor/carpet/red,
/area/ruin/unpowered/ash_walkers)
"kb" = (
/obj/structure/closet/crate,
/obj/item/reagent_containers/glass/bottle/ammonia,
/obj/item/reagent_containers/glass/bottle/ammonia,
/obj/item/reagent_containers/glass/bottle/ammonia,
/obj/item/reagent_containers/glass/bottle/ammonia,
/obj/item/reagent_containers/glass/bottle/ammonia,
/obj/item/reagent_containers/glass/bottle/ammonia,
/obj/item/reagent_containers/glass/bottle/ammonia,
/obj/item/reagent_containers/glass/bottle/ammonia,
/obj/item/reagent_containers/glass/bottle/ammonia,
/obj/item/reagent_containers/glass/bottle/ammonia,
/obj/item/reagent_containers/glass/bottle/ammonia,
/obj/item/reagent_containers/spray/pestspray,
/obj/item/reagent_containers/spray/pestspray,
/obj/item/reagent_containers/spray/pestspray,
/obj/item/reagent_containers/spray/pestspray,
/obj/item/reagent_containers/spray/pestspray,
/obj/item/reagent_containers/spray/pestspray,
/obj/item/reagent_containers/spray/pestspray,
/obj/item/reagent_containers/spray/pestspray,
/obj/item/reagent_containers/spray/pestspray,
/obj/item/reagent_containers/spray/pestspray,
/obj/item/reagent_containers/spray/pestspray,
/turf/open/floor/vault,
/area/ruin/unpowered/ash_walkers)
"kj" = (
/obj/structure/closet/cabinet,
/obj/item/clothing/under/rank/civilian/chaplain,
/obj/item/clothing/under/rank/civilian/chaplain,
/obj/item/clothing/under/rank/civilian/chaplain,
/obj/item/clothing/under/color/brown,
/obj/item/clothing/under/color/brown,
/obj/item/clothing/under/color/brown,
/obj/item/clothing/gloves/color/brown,
/obj/item/clothing/gloves/fingerless,
/obj/item/flashlight/flare/torch,
/obj/item/flashlight/flare/torch,
/obj/item/flashlight/flare/torch,
/obj/item/flashlight/flare/torch,
/obj/item/flashlight/flare/torch,
/obj/item/flashlight/lantern,
/obj/item/flashlight/lantern,
/turf/open/floor/vault,
/area/ruin/unpowered/ash_walkers)
"ko" = (
/obj/structure/closet/secure_closet/freezer/fridge,
/obj/item/reagent_containers/food/drinks/waterbottle,
/obj/item/reagent_containers/food/condiment/flour,
/obj/item/reagent_containers/food/condiment/mayonnaise,
/obj/item/reagent_containers/food/condiment/milk,
/obj/item/reagent_containers/food/condiment/milk,
/obj/item/reagent_containers/food/condiment/soymilk,
/obj/item/reagent_containers/food/condiment/flour,
/obj/item/reagent_containers/food/condiment/rice,
/obj/item/reagent_containers/food/condiment/rice,
/obj/item/reagent_containers/food/condiment/sugar,
/obj/item/reagent_containers/food/condiment/sugar,
/obj/item/reagent_containers/food/condiment/enzyme,
/obj/item/stack/sheet/mineral/coal/ten{
	amount = 50
	},
/turf/open/floor/vault,
/area/ruin/unpowered/ash_walkers)
"kN" = (
/obj/item/pipe_dispenser,
/turf/open/floor/vault,
/area/ruin/unpowered/ash_walkers)
"lL" = (
/obj/item/paper{
	info = "smithy stuff goes here"
	},
/obj/structure/table/wood,
/turf/open/floor/vault,
/area/ruin/unpowered/ash_walkers)
"lM" = (
/obj/machinery/door/airlock/vault{
	id_tag = "cell1"
	},
/obj/structure/fans/tiny/invisible,
/turf/open/floor/vault,
/area/ruin/unpowered/ash_walkers)
"mp" = (
/obj/machinery/grill,
/turf/open/floor/vault,
/area/ruin/unpowered/ash_walkers)
"nf" = (
/obj/structure/curtain/cloth/fancy,
/turf/open/floor/carpet/red,
/area/ruin/unpowered/ash_walkers)
"nD" = (
/obj/machinery/button/door{
	id = 'ashcastle';
	pixel_y = -23
	},
/obj/item/flashlight/flare/torch,
/turf/open/floor/plating/asteroid{
	initial_gas_mix = "LAVALAND_ATMOS"
	},
/area/ruin/unpowered/ash_walkers)
"pv" = (
/obj/structure/mineral_door/wood,
/turf/open/floor/vault,
/area/ruin/unpowered/ash_walkers)
"pD" = (
/obj/structure/closet/crate/goldcrate,
/obj/item/melee/transforming/energy/sword/saber/blue,
/obj/item/malf_upgrade,
/turf/open/floor/vault,
/area/ruin/unpowered/ash_walkers)
"pL" = (
/obj/structure/table/optable,
/turf/open/floor/vault,
/area/ruin/unpowered/ash_walkers)
"pW" = (
/obj/structure/table/wood,
/obj/item/stamp/hos,
/turf/open/floor/carpet/red,
/area/ruin/unpowered/ash_walkers)
"qa" = (
/obj/structure/stone_tile/slab,
/obj/item/flashlight/flare/torch,
/turf/open/indestructible/boss,
/area/ruin/unpowered/ash_walkers)
"qv" = (
/obj/item/gun/ballistic/bow,
/obj/structure/rack,
/turf/open/floor/vault,
/area/ruin/unpowered/ash_walkers)
"qK" = (
/obj/structure/closet/crate,
/obj/item/flashlight/lantern,
/obj/item/flashlight/lantern,
/obj/item/flashlight/lantern,
/obj/item/flashlight/lantern,
/obj/item/flashlight/lantern,
/obj/item/flashlight/lantern,
/obj/item/flashlight/lantern,
/obj/item/flashlight/lantern,
/obj/item/flashlight/lantern,
/obj/item/flashlight/lantern,
/turf/open/floor/vault,
/area/ruin/unpowered/ash_walkers)
"rt" = (
/obj/structure/closet/cabinet,
/obj/item/clothing/neck/cloak/hos,
/obj/item/clothing/gloves/krav_maga/sec,
/obj/item/clothing/suit/armor/riot/chaplain,
/obj/item/clothing/head/helmet/chaplain,
/obj/item/melee/transforming/energy/sword/saber/red,
/turf/open/floor/carpet/red,
/area/ruin/unpowered/ash_walkers)
"rC" = (
/turf/open/floor/vault,
/area/ruin/unpowered/ash_walkers)
"rS" = (
/obj/structure/railing{
	dir = 8
	},
/turf/open/floor/vault,
/area/lavaland/surface/outdoors)
"sA" = (
/obj/structure/chair/wood{
	dir = 8
	},
/turf/open/floor/carpet/red,
/area/ruin/unpowered/ash_walkers)
"sR" = (
/obj/item/flashlight/flare/torch,
/turf/open/floor/plating,
/area/ruin/unpowered/ash_walkers)
"sU" = (
/obj/item/flashlight/flare/torch,
/turf/open/floor/plating/asteroid{
	initial_gas_mix = "LAVALAND_ATMOS"
	},
/area/lavaland/surface/outdoors)
"tg" = (
/obj/machinery/power/port_gen/pacman,
/obj/item/stack/sheet/mineral/plasma/twenty,
/obj/machinery/power/apc/auto_name/east,
/obj/machinery/power/terminal{
	dir = 4
	},
/obj/structure/cable,
/turf/open/floor/vault,
/area/ruin/unpowered/ash_walkers)
"tF" = (
/turf/open/floor/plasteel/stairs,
/area/ruin/unpowered/ash_walkers)
"tR" = (
/obj/structure/rack,
/obj/item/clothing/suit/armor/riot/knight/blue,
/obj/item/clothing/suit/armor/riot/knight/blue,
/obj/item/clothing/suit/armor/riot/knight/blue,
/obj/item/clothing/head/helmet/knight/blue,
/obj/item/clothing/head/helmet/knight/blue,
/obj/item/clothing/head/helmet/knight/blue,
/obj/item/clothing/suit/armor/riot/knight/blue,
/obj/item/clothing/suit/armor/riot/knight/blue,
/obj/item/clothing/suit/armor/riot/knight/blue,
/obj/item/clothing/head/helmet/knight/blue,
/obj/item/clothing/head/helmet/knight/blue,
/obj/item/clothing/head/helmet/knight/blue,
/turf/open/floor/vault,
/area/ruin/unpowered/ash_walkers)
"ul" = (
/obj/structure/table/wood/fancy,
/obj/item/clothing/neck/cloak/ce,
/obj/item/clothing/gloves/combat,
/obj/item/storage/belt/utility/chief/full,
/turf/open/floor/carpet/red,
/area/ruin/unpowered/ash_walkers)
"us" = (
/obj/structure/chair/pew,
/turf/open/floor/vault,
/area/ruin/unpowered/ash_walkers)
"uy" = (
/obj/structure/table/wood,
/obj/item/reagent_containers/food/condiment/peppermill,
/obj/item/reagent_containers/food/condiment/saltshaker{
	pixel_x = -8
	},
/turf/open/floor/vault,
/area/ruin/unpowered/ash_walkers)
"uH" = (
/obj/structure/sink/puddle,
/turf/open/floor/plating/asteroid/basalt/lava_land_surface,
/area/lavaland/surface/outdoors)
"vf" = (
/obj/structure/grille/indestructable,
/turf/open/floor/plating,
/area/ruin/unpowered/ash_walkers)
"vC" = (
/turf/open/floor/plating/asteroid{
	initial_gas_mix = "LAVALAND_ATMOS"
	},
/area/ruin/unpowered/ash_walkers)
"vJ" = (
/obj/item/claymore{
	force = 18
	},
/obj/structure/rack,
/turf/open/floor/vault,
/area/ruin/unpowered/ash_walkers)
"wl" = (
/obj/item/flashlight/flare/torch,
/turf/open/floor/vault,
/area/ruin/unpowered/ash_walkers)
"wv" = (
/obj/structure/table/wood,
/turf/open/floor/carpet/red,
/area/ruin/unpowered/ash_walkers)
"xv" = (
/turf/open/floor/carpet/red,
/area/ruin/unpowered/ash_walkers)
"xB" = (
/obj/structure/mineral_door/wood,
/obj/structure/fans/tiny/invisible,
/turf/open/floor/vault,
/area/ruin/unpowered/ash_walkers)
"xS" = (
/obj/structure/table/wood,
/obj/item/clothing/under/rank/medical/doctor/green,
/obj/item/clothing/gloves/color/latex,
/turf/open/floor/vault,
/area/ruin/unpowered/ash_walkers)
"yt" = (
/obj/structure/chair/wood/wings{
	pixel_y = 6
	},
/obj/structure/table/wood/fancy,
/turf/open/floor/carpet/red,
/area/ruin/unpowered/ash_walkers)
"zj" = (
/obj/structure/table/wood,
/obj/item/storage/fancy/cigarettes/cigars,
/obj/item/storage/fancy/cigarettes,
/obj/item/lighter/greyscale{
	pixel_x = 8
	},
/turf/open/floor/vault,
/area/ruin/unpowered/ash_walkers)
"zJ" = (
/turf/template_noop,
/area/template_noop)
"zU" = (
/obj/structure/chair/pew/left,
/turf/open/floor/vault,
/area/ruin/unpowered/ash_walkers)
"Af" = (
/obj/structure/table/wood/fancy,
/obj/item/paper_bin/bundlenatural,
/obj/item/pen/charcoal,
/turf/open/floor/carpet/red,
/area/ruin/unpowered/ash_walkers)
"At" = (
/obj/structure/bonfire/prelit,
/obj/item/claymore{
	force = 18
	},
/obj/structure/railing{
	dir = 8
	},
/turf/open/floor/vault,
/area/ruin/unpowered/ash_walkers)
"Ax" = (
/obj/structure/railing{
	dir = 4
	},
/turf/open/floor/vault,
/area/lavaland/surface/outdoors)
"BL" = (
/obj/structure/lavaland/ash_walker,
/obj/structure/stone_tile/surrounding_tile{
	dir = 8
	},
/obj/structure/stone_tile/surrounding_tile/cracked,
/obj/structure/stone_tile/surrounding_tile{
	dir = 1
	},
/obj/structure/stone_tile/surrounding_tile{
	dir = 4
	},
/turf/open/lava/smooth,
/area/ruin/unpowered/ash_walkers)
"BZ" = (
/obj/structure/table/wood,
/obj/item/storage/firstaid/medical,
/obj/item/storage/firstaid/brute,
/obj/item/storage/firstaid/fire,
/obj/item/storage/firstaid/toxin,
/turf/open/floor/vault,
/area/ruin/unpowered/ash_walkers)
"DI" = (
/obj/structure/closet/crate/internals,
/obj/item/pickaxe/silver,
/obj/item/pickaxe/silver,
/obj/item/pickaxe/silver,
/obj/item/pickaxe/silver,
/obj/item/pickaxe/silver,
/obj/item/pickaxe/silver,
/obj/item/pickaxe/silver,
/obj/item/mining_scanner,
/turf/open/floor/vault,
/area/ruin/unpowered/ash_walkers)
"Fm" = (
/obj/structure/mineral_door/iron,
/turf/open/floor/vault,
/area/ruin/unpowered/ash_walkers)
"Fr" = (
/obj/structure/chair/wood,
/turf/open/floor/carpet/red,
/area/ruin/unpowered/ash_walkers)
"FE" = (
/obj/machinery/door/airlock/vault{
	id_tag = "cell4"
	},
/obj/structure/fans/tiny/invisible,
/turf/open/floor/vault,
/area/ruin/unpowered/ash_walkers)
"Gb" = (
/obj/structure/ore_box,
/turf/open/floor/vault,
/area/ruin/unpowered/ash_walkers)
"Gr" = (
/obj/structure/table/wood/fancy,
/obj/item/clothing/neck/cloak/cmo,
/obj/item/clothing/gloves/color/latex/nitrile,
/obj/item/clothing/head/beret/cmo,
/obj/item/clothing/under/rank/medical/chief_medical_officer/surgeon_general,
/turf/open/floor/carpet/red,
/area/ruin/unpowered/ash_walkers)
"GH" = (
/obj/structure/table/wood/fancy,
/obj/item/clothing/head/chefhat,
/turf/open/floor/carpet/red,
/area/ruin/unpowered/ash_walkers)
"Hc" = (
/obj/structure/table/wood/fancy,
/obj/item/clothing/neck/cloak/rd,
/turf/open/floor/carpet/red,
/area/ruin/unpowered/ash_walkers)
"HO" = (
/obj/machinery/autolathe,
/turf/open/floor/vault,
/area/ruin/unpowered/ash_walkers)
"IC" = (
/obj/item/shield/riot/roman,
/obj/structure/rack,
/turf/open/floor/vault,
/area/ruin/unpowered/ash_walkers)
"IK" = (
/obj/item/storage/bag/plants/portaseeder,
/obj/item/storage/bag/plants/portaseeder,
/obj/item/storage/bag/plants/portaseeder,
/turf/open/floor/vault,
/area/ruin/unpowered/ash_walkers)
"IV" = (
/obj/structure/closet/crate/silvercrate,
/obj/item/shield/riot/tele,
/obj/item/gun/ballistic/automatic/l6_saw/unrestricted,
/turf/open/floor/vault,
/area/ruin/unpowered/ash_walkers)
"Jn" = (
/obj/item/flashlight/flare/torch,
/turf/open/floor/plating/asteroid{
	initial_gas_mix = "LAVALAND_ATMOS"
	},
/area/ruin/unpowered/ash_walkers)
"Jr" = (
/obj/structure/table/wood,
/obj/item/circuitboard/machine/ore_redemption,
/obj/item/stack/cable_coil,
/obj/item/wrench/old,
/turf/open/floor/vault,
/area/ruin/unpowered/ash_walkers)
"JS" = (
/obj/structure/mineral_door/wood,
/obj/structure/fans/tiny/invisible,
/turf/open/floor/vault,
/area/lavaland/surface/outdoors)
"JT" = (
/turf/open/floor/carpet/royalblack,
/area/ruin/unpowered/ash_walkers)
"KZ" = (
/obj/structure/rack,
/obj/item/storage/bag/quiver/empty,
/obj/item/ammo_casing/caseless/arrow/ash,
/obj/item/ammo_casing/caseless/arrow/ash,
/obj/item/ammo_casing/caseless/arrow/ash,
/obj/item/ammo_casing/caseless/arrow/ash,
/obj/item/ammo_casing/caseless/arrow/ash,
/obj/item/ammo_casing/caseless/arrow/ash,
/turf/open/floor/vault,
/area/ruin/unpowered/ash_walkers)
"LK" = (
/obj/structure/table/wood,
/obj/item/storage/toolbox/syndicate,
/turf/open/floor/vault,
/area/ruin/unpowered/ash_walkers)
"LL" = (
/obj/machinery/door/airlock/vault{
	id_tag = "cell2"
	},
/obj/structure/fans/tiny/invisible,
/turf/open/floor/vault,
/area/ruin/unpowered/ash_walkers)
"Me" = (
/obj/structure/curtain/cloth/fancy,
/turf/open/floor/vault,
/area/ruin/unpowered/ash_walkers)
"Mp" = (
/obj/structure/closet/crate,
/obj/item/storage/belt/utility/full,
/obj/item/construction/rcd/loaded,
/obj/item/storage/box/lights/mixed,
/obj/item/storage/box/lights/mixed,
/obj/item/storage/box/lights/tubes,
/obj/item/storage/box/lights/bulbs,
/obj/item/storage/box/lights/tubes,
/obj/item/storage/box/lights/bulbs,
/turf/open/floor/vault,
/area/ruin/unpowered/ash_walkers)
"MD" = (
/obj/structure/chair/wood{
	dir = 1
	},
/turf/open/floor/vault,
/area/ruin/unpowered/ash_walkers)
"MG" = (
/obj/structure/table/wood,
/obj/item/gavelhammer,
/turf/open/floor/vault,
/area/ruin/unpowered/ash_walkers)
"MM" = (
/turf/open/floor/plating,
/area/ruin/unpowered/ash_walkers)
"Na" = (
/obj/structure/mineral_door/wood,
/turf/open/floor/carpet,
/area/ruin/unpowered/ash_walkers)
"ND" = (
/obj/item/shovel,
/obj/item/shovel,
/obj/item/shovel,
/obj/item/shovel,
/obj/item/shovel,
/turf/open/floor/vault,
/area/ruin/unpowered/ash_walkers)
"PC" = (
/obj/machinery/deepfryer,
/turf/open/floor/vault,
/area/ruin/unpowered/ash_walkers)
"PI" = (
/obj/structure/table/wood,
/turf/open/floor/vault,
/area/ruin/unpowered/ash_walkers)
"QA" = (
/turf/open/floor/carpet,
/area/ruin/unpowered/ash_walkers)
"QC" = (
/obj/structure/rack,
/obj/item/clothing/gloves/plate/blue,
/obj/item/clothing/gloves/plate/blue,
/obj/item/clothing/gloves/plate/blue,
/obj/item/clothing/shoes/plate/blue,
/obj/item/clothing/shoes/plate/blue,
/obj/item/clothing/shoes/plate/blue,
/obj/item/clothing/shoes/plate/blue,
/obj/item/clothing/shoes/plate/blue,
/obj/item/clothing/shoes/plate/blue,
/obj/item/clothing/gloves/plate/blue,
/obj/item/clothing/gloves/plate/blue,
/obj/item/clothing/gloves/plate/blue,
/turf/open/floor/vault,
/area/ruin/unpowered/ash_walkers)
"Sw" = (
/obj/item/bedsheet/head_of_personnel,
/obj/structure/bed,
/obj/effect/mob_spawn/human/ash_walker,
/turf/open/floor/carpet/red,
/area/ruin/unpowered/ash_walkers)
"SZ" = (
/obj/item/bedsheet/captain,
/obj/structure/bed,
/obj/effect/mob_spawn/human/ash_walker,
/turf/open/floor/carpet/red,
/area/ruin/unpowered/ash_walkers)
"Tb" = (
/obj/machinery/button/door{
	id = "cell2";
	name = "Cell 2 lock";
	normaldoorcontrol = 1;
	pixel_x = -25;
	specialfunctions = 4
	},
/obj/machinery/button/door{
	id = "cell4";
	name = "Cell 4 lock";
	normaldoorcontrol = 1;
	pixel_x = 25;
	specialfunctions = 4
	},
/turf/open/floor/vault,
/area/ruin/unpowered/ash_walkers)
"Tj" = (
/obj/structure/closet/cabinet,
/obj/item/clothing/head/fedora/det_hat,
/obj/item/claymore{
	force = 18
	},
/turf/open/floor/vault,
/area/ruin/unpowered/ash_walkers)
"TW" = (
/obj/structure/table/wood,
/obj/item/flashlight/flare/torch,
/turf/open/floor/carpet/red,
/area/ruin/unpowered/ash_walkers)
"Uk" = (
/obj/structure/stone_tile/slab,
/turf/open/indestructible/boss,
/area/ruin/unpowered/ash_walkers)
"Ul" = (
/turf/closed/wall/mineral/iron,
/area/lavaland/surface/outdoors)
"Uq" = (
/obj/item/seeds/apple,
/obj/item/seeds/banana,
/obj/item/seeds/berry,
/obj/item/seeds/cabbage,
/obj/item/seeds/carrot,
/obj/item/seeds/chili,
/obj/item/seeds/cherry,
/obj/item/seeds/cocoapod,
/obj/item/seeds/cotton,
/obj/item/seeds/corn,
/obj/item/seeds/garlic,
/obj/item/seeds/eggplant,
/obj/item/seeds/orange,
/obj/item/seeds/onion,
/obj/item/seeds/lemon,
/obj/item/seeds/lime,
/obj/item/seeds/pineapple,
/obj/item/seeds/potato,
/obj/item/seeds/pumpkin,
/obj/item/seeds/sugarcane,
/obj/item/seeds/tea,
/obj/item/seeds/tobacco,
/obj/item/seeds/tomato,
/obj/item/seeds/wheat,
/obj/item/seeds/watermelon,
/obj/structure/closet/crate,
/obj/item/seeds/cotton/durathread,
/obj/item/seeds/tower,
/obj/item/seeds/tower,
/obj/item/seeds/glowshroom,
/obj/item/seeds/glowshroom,
/turf/open/floor/vault,
/area/ruin/unpowered/ash_walkers)
"UM" = (
/obj/structure/curtain/cloth/fancy,
/obj/structure/table/wood,
/obj/item/clothing/head/crown/fancy,
/turf/open/floor/carpet/red,
/area/ruin/unpowered/ash_walkers)
"VN" = (
/obj/structure/closet/crate/medical,
/obj/item/weldingtool/experimental,
/obj/item/kitchen/knife/bloodletter,
/obj/item/stock_parts/cell/upgraded/plus,
/obj/item/melee/baton/cattleprod,
/obj/item/chainsaw,
/obj/item/reagent_containers/blood/lizard,
/obj/item/reagent_containers/blood/lizard,
/obj/item/reagent_containers/blood/lizard,
/turf/open/floor/vault,
/area/ruin/unpowered/ash_walkers)
"WH" = (
/obj/structure/table/wood,
/obj/item/paper_bin/bundlenatural,
/obj/item/pen/charcoal,
/turf/open/floor/carpet/red,
/area/ruin/unpowered/ash_walkers)
"Xl" = (
/obj/structure/bed/pod,
/turf/open/floor/plating,
/area/ruin/unpowered/ash_walkers)
"XE" = (
/turf/open/lava/smooth,
/area/lavaland/surface/outdoors)
"XI" = (
/obj/structure/table/wood/fancy,
/obj/item/flashlight/flare/torch,
/turf/open/floor/carpet/red,
/area/ruin/unpowered/ash_walkers)
"XP" = (
/obj/machinery/door/airlock/vault{
	id_tag = "cell3"
	},
/obj/structure/fans/tiny/invisible,
/turf/open/floor/plating,
/area/ruin/unpowered/ash_walkers)
"YI" = (
/obj/structure/sacrificealtar,
/obj/item/storage/book/bible,
/turf/open/floor/vault,
/area/ruin/unpowered/ash_walkers)
"YL" = (
/obj/structure/sink/puddle,
/turf/open/floor/plating,
/area/ruin/unpowered/ash_walkers)
"Zd" = (
/obj/item/flashlight/flare/torch,
/turf/open/floor/carpet/red,
/area/ruin/unpowered/ash_walkers)
"ZN" = (
/obj/structure/closet/crate,
/obj/item/flashlight/flare/torch,
/obj/item/flashlight/flare/torch,
/obj/item/flashlight/flare/torch,
/obj/item/flashlight/flare/torch,
/obj/item/flashlight/flare/torch,
/obj/item/flashlight/flare/torch,
/obj/item/flashlight/flare/torch,
/obj/item/flashlight/flare/torch,
/obj/item/flashlight/flare/torch,
/obj/item/flashlight/flare/torch,
/obj/item/flashlight/flare/torch,
/obj/item/flashlight/flare/torch,
/obj/item/flashlight/flare/torch,
/obj/item/flashlight/flare/torch,
/obj/item/flashlight/flare/torch,
/obj/item/flashlight/flare/torch,
/obj/item/flashlight/flare/torch,
/obj/item/flashlight/flare/torch,
/obj/item/flashlight/flare/torch,
/obj/item/flashlight/flare/torch,
/obj/item/flashlight/flare/torch,
/obj/item/flashlight/flare/torch,
/turf/open/floor/vault,
/area/ruin/unpowered/ash_walkers)
"ZR" = (
/obj/structure/closet/crate,
/obj/item/cultivator/rake,
/obj/item/cultivator/rake,
/obj/item/cultivator/rake,
/obj/item/hatchet/wooden,
/obj/item/hatchet/wooden,
/obj/item/hatchet/wooden,
/obj/item/stack/sheet/mineral/wood/fifty,
/obj/item/stack/sheet/mineral/wood/fifty,
/obj/item/stack/sheet/mineral/wood/fifty,
/turf/open/floor/vault,
/area/ruin/unpowered/ash_walkers)

(1,1,1) = {"
gC
gC
gC
gC
gC
gC
gC
gC
gC
zJ
zJ
zJ
zJ
zJ
zJ
zJ
zJ
gC
gC
zJ
zJ
zJ
zJ
zJ
zJ
zJ
zJ
zJ
zJ
gC
gC
gC
gC
gC
gC
gC
gC
gC
gC
gC
zJ
"}
(2,1,1) = {"
gC
hv
hv
hv
hv
hv
hv
gC
gC
gC
gC
gC
gC
gC
gC
gC
gC
gC
gC
gC
gC
gC
gC
gC
gC
gC
gC
gC
gC
gC
gC
hv
hv
hv
hv
hv
hv
gC
gC
gC
zJ
"}
(3,1,1) = {"
gC
hv
rC
rC
rC
rC
hv
hv
hv
hv
hv
hv
hv
hv
hv
hv
hv
hv
hv
hv
hv
hv
hv
hv
hv
hv
hv
hv
hv
hv
hv
hv
rC
rC
rC
rC
hv
gC
gC
zJ
zJ
"}
(4,1,1) = {"
zJ
hv
rC
rC
rC
rC
hv
ey
ey
ey
ey
ey
ey
ey
ey
ey
ey
ey
ey
ey
ey
ey
ey
ey
ey
ey
ey
ey
ey
ey
sU
hv
rC
rC
rC
rC
hv
gC
gC
zJ
zJ
"}
(5,1,1) = {"
zJ
hv
rC
rC
rC
rC
hv
ey
ey
ey
ey
ey
ey
ey
ey
ey
ey
ey
ey
ey
ey
ey
ey
ey
ey
ey
ey
ey
ey
ey
ey
hv
rC
rC
rC
rC
hv
gC
gC
zJ
zJ
"}
(6,1,1) = {"
zJ
hv
rC
rC
rC
rC
Fm
ey
ey
ey
ey
ey
ey
ey
ey
ey
ey
ey
ey
ey
ey
ey
ey
ey
ey
ey
ey
ey
ey
ey
ey
Fm
rC
rC
rC
rC
hv
gC
zJ
zJ
zJ
"}
(7,1,1) = {"
zJ
hv
hv
hv
hv
hv
hv
ey
ey
ey
ey
ey
ey
ey
ey
ey
ey
ey
ey
ey
ey
ey
ey
ey
ey
ey
ey
ey
ey
ey
ey
hv
hv
hv
hv
hv
hv
gC
zJ
zJ
zJ
"}
(8,1,1) = {"
zJ
gC
hv
sU
ey
ey
ey
ey
vC
vC
vC
vC
vC
Jn
hv
hv
hv
hv
hv
hv
hv
xB
hv
hv
hv
hv
hv
hv
ey
ey
ey
ey
ey
ey
sU
hv
gC
gC
zJ
zJ
zJ
"}
(9,1,1) = {"
zJ
gC
hv
ey
ey
ey
ey
ey
hv
hv
hv
hv
xB
hv
hv
ko
PC
PI
fS
hv
wl
rC
hv
zU
zU
rC
wl
hv
hv
vC
ey
ey
ey
ey
ey
hv
gC
gC
zJ
zJ
zJ
"}
(10,1,1) = {"
gC
gC
hv
ey
ey
ey
ey
ey
hv
rC
rC
rC
rC
rC
hv
xv
xv
xv
xv
hv
rC
rC
hv
us
us
rC
rC
rC
hv
Jn
ey
ey
ey
ey
ey
hv
gC
gC
zJ
zJ
zJ
"}
(11,1,1) = {"
gC
gC
hv
ey
ey
ey
ey
ey
hv
PI
PI
lL
PI
rC
hv
xv
GH
XI
xv
pv
rC
rC
hv
gL
gL
rC
rC
rC
hv
hv
hv
ey
ey
ey
ey
hv
gC
gC
zJ
zJ
zJ
"}
(12,1,1) = {"
gC
gC
hv
ey
ey
ey
ey
ey
hv
MG
rC
rC
rC
rC
hv
xv
xv
xv
xv
hv
rC
rC
hv
Zd
xv
rC
PI
rC
Uk
qa
hv
ey
ey
ey
ey
hv
gC
gC
zJ
zJ
zJ
"}
(13,1,1) = {"
gC
gC
hv
ey
ey
ey
ey
sU
hv
PI
At
jy
jy
jy
hv
mp
uy
PI
fS
hv
rC
rC
pv
xv
xv
rC
YI
rC
BL
Uk
hv
ey
ey
ey
ey
hv
gC
gC
zJ
zJ
zJ
"}
(14,1,1) = {"
gC
gC
hv
ey
ey
ey
ey
hv
hv
hv
hv
hv
hv
hv
hv
hv
hv
hv
hv
hv
rC
rC
hv
Zd
xv
rC
PI
rC
Uk
qa
hv
ey
ey
ey
ey
hv
gC
gC
zJ
zJ
zJ
"}
(15,1,1) = {"
gC
gC
hv
ey
ey
ey
ey
hv
pD
rC
rC
rC
Me
xv
xv
rC
rC
rC
wl
hv
wl
rC
hv
zU
zU
rC
rC
rC
hv
hv
hv
ey
ey
ey
ey
hv
gC
gC
zJ
zJ
zJ
"}
(16,1,1) = {"
gC
gC
hv
ey
ey
ey
vC
hv
JT
JT
JT
JT
hv
XI
xv
cq
cq
cq
xv
hv
rC
rC
hv
us
us
rC
rC
rC
hv
ey
ey
ey
ey
ey
ey
hv
gC
gC
gC
zJ
zJ
"}
(17,1,1) = {"
gC
gC
hv
ey
ey
ey
vC
hv
jQ
aW
nf
JT
hv
yt
xv
ul
bh
Gr
xv
hv
rC
rC
hv
gL
gL
rC
wl
hv
hv
ey
ey
ey
ey
ey
ey
hv
iZ
gC
gC
zJ
zJ
"}
(18,1,1) = {"
gC
gC
hv
ey
ey
ey
vC
hv
SZ
Sw
nf
JT
hv
bh
xv
Af
XI
bh
xv
pv
rC
rC
hv
hv
hv
hv
hv
hv
ey
ey
ey
ey
ey
ey
sU
hv
iZ
iZ
gC
gC
zJ
"}
(19,1,1) = {"
zJ
gC
hv
ey
ey
ey
vC
hv
jQ
UM
nf
JT
hv
yt
xv
cR
bh
Hc
xv
hv
rC
rC
hv
vC
vC
vC
vC
ey
ey
ey
hv
hv
hv
hv
hv
hv
iZ
iZ
gC
gC
zJ
"}
(20,1,1) = {"
zJ
gC
hv
ey
ey
ey
vC
hv
JT
JT
JT
JT
hv
XI
xv
sA
sA
sA
xv
hv
rC
rC
hv
vC
vC
vC
vC
ey
ey
ey
hv
XE
XE
XE
XE
XE
iZ
iZ
iZ
gC
gC
"}
(21,1,1) = {"
zJ
gC
hv
ey
ey
ey
vC
hv
IV
rC
rC
rC
Me
xv
xv
rC
rC
rC
wl
hv
rC
rC
hv
vC
vC
vC
vC
ey
ey
ey
hv
XE
XE
XE
XE
XE
iZ
iZ
iZ
iZ
gC
"}
(22,1,1) = {"
zJ
gC
hv
ey
ey
hv
hv
hv
hv
hv
hv
hv
hv
hv
hv
hv
hv
hv
hv
hv
wl
rC
hv
Jn
vC
vC
vC
ey
ey
sU
hv
XE
XE
XE
XE
XE
iZ
iZ
iZ
iZ
gC
"}
(23,1,1) = {"
zJ
gC
hv
ey
ey
hv
vJ
vJ
vJ
KZ
KZ
KZ
qv
hv
Xl
sR
hv
Xl
sR
hv
rC
rC
xB
vC
vC
vC
vC
ey
ey
ey
iT
rS
rS
rS
rS
rS
hl
iZ
iZ
iZ
gC
"}
(24,1,1) = {"
zJ
gC
hv
ey
ey
hv
wl
rC
rC
rC
rC
rC
qv
hv
MM
MM
hv
MM
MM
hv
rC
rC
xB
vC
vC
vC
vC
ey
ey
ey
iT
Ax
Ax
Ax
Ax
Ax
by
iZ
iZ
iZ
gC
"}
(25,1,1) = {"
zJ
gC
hv
ey
ey
hv
IC
IC
IC
tR
QC
rC
qv
hv
MM
YL
hv
MM
YL
hv
rC
rC
hv
Jn
vC
vC
vC
ey
ey
nD
hv
XE
XE
XE
XE
XE
iZ
iZ
iZ
iZ
gC
"}
(26,1,1) = {"
zJ
gC
hv
ey
ey
hv
hv
hv
hv
hv
hv
pv
vf
hv
lM
vf
hv
LL
vf
hv
rC
rC
hv
vC
vC
vC
vC
ey
ey
ey
hv
XE
XE
XE
XE
XE
iZ
iZ
iZ
iZ
gC
"}
(27,1,1) = {"
zJ
gC
hv
ey
ey
hv
xv
xv
xv
pv
tF
rC
rC
dT
rC
rC
Tb
rC
rC
pv
rC
rC
hv
hv
hv
hv
hv
ey
ey
ey
hv
XE
XE
XE
XE
XE
iZ
iZ
iZ
gC
gC
"}
(28,1,1) = {"
zJ
gC
hv
ey
ey
hv
xv
xv
xv
hv
hv
pv
vf
hv
XP
vf
hv
FE
vf
hv
rC
rC
hv
gw
gw
gw
hv
ey
ey
ey
hv
hv
hv
hv
hv
hv
iZ
iZ
iZ
gC
gC
"}
(29,1,1) = {"
gC
gC
hv
ey
ey
hv
xv
xv
TW
hv
zj
rC
rC
hv
MM
YL
hv
MM
YL
hv
rC
rC
Na
QA
QA
QA
hv
ey
ey
ey
ey
hv
ND
rC
qK
hv
iZ
iZ
gC
gC
gC
"}
(30,1,1) = {"
gC
gC
hv
ey
ey
hv
xv
Fr
WH
hv
fS
MD
rC
hv
MM
MM
hv
MM
MM
hv
rC
rC
hv
bR
QA
kj
hv
ey
ey
ey
ey
hv
rC
rC
ZN
hv
iZ
uH
gC
gC
gC
"}
(31,1,1) = {"
gC
gC
hv
ey
ey
hv
rt
wv
pW
hv
Tj
rC
rC
hv
Xl
sR
hv
Xl
sR
hv
rC
rC
hv
bR
QA
kj
hv
ey
ey
ey
ey
hv
IK
rC
kb
hv
gC
gC
gC
gC
zJ
"}
(32,1,1) = {"
gC
gC
hv
ey
ey
hv
hv
hv
hv
hv
vf
pv
vf
hv
hv
hv
hv
hv
hv
hv
rC
rC
hv
bR
QA
kj
hv
ey
ey
ey
sU
hv
wl
rC
Uq
hv
gC
gC
gC
zJ
zJ
"}
(33,1,1) = {"
gC
gC
hv
ey
ey
ey
ey
vC
vC
hv
wl
rC
rC
rC
rC
rC
rC
rC
rC
rC
rC
rC
hv
bR
QA
kj
hv
ey
ey
ey
ey
xB
rC
rC
ZR
hv
gC
gC
gC
zJ
zJ
"}
(34,1,1) = {"
gC
gC
hv
ey
ey
ey
ey
vC
vC
xB
rC
rC
rC
rC
rC
rC
rC
rC
rC
rC
rC
rC
hv
bR
QA
kj
hv
ey
ey
ey
sU
hv
wl
rC
Gb
hv
gC
gC
zJ
zJ
zJ
"}
(35,1,1) = {"
gC
gC
hv
ey
ey
ey
ey
vC
vC
hv
hv
hv
hv
hv
hv
pv
hv
hv
hv
hv
pv
hv
hv
hv
hv
hv
hv
ey
ey
ey
ey
hv
DI
rC
Gb
hv
gC
gC
zJ
zJ
zJ
"}
(36,1,1) = {"
zJ
gC
hv
ey
ey
ey
ey
ey
vC
vC
vC
Jn
hv
fS
QA
QA
QA
kN
hv
wl
QA
QA
VN
hv
Jn
vC
ey
ey
ey
ey
ey
hv
hv
hv
hv
hv
gC
gC
zJ
zJ
zJ
"}
(37,1,1) = {"
zJ
gC
hv
ey
ey
ey
ey
ey
vC
vC
vC
vC
hv
HO
QA
QA
QA
fS
hv
fS
QA
QA
BZ
hv
vC
vC
ey
ey
ey
ey
ey
Ul
aX
aX
aX
hv
gC
gC
zJ
zJ
zJ
"}
(38,1,1) = {"
zJ
gC
hv
ey
ey
ey
ey
ey
ey
vC
vC
vC
hv
Jr
QA
QA
QA
fU
hv
LK
QA
QA
xS
hv
vC
vC
ey
ey
ey
ey
ey
JS
aX
aX
aX
hv
gC
gC
zJ
zJ
zJ
"}
(39,1,1) = {"
zJ
gC
hv
sU
ey
ey
ey
ey
ey
ey
vC
vC
hv
tg
QA
QA
QA
Mp
hv
dw
QA
QA
pL
hv
vC
vC
ey
ey
ey
ey
ey
Ul
aX
aX
aX
hv
gC
gC
zJ
zJ
zJ
"}
(40,1,1) = {"
zJ
hv
hv
hv
hv
hv
hv
ey
ey
ey
ey
ey
hv
hv
iv
iv
iv
hv
hv
hv
hv
hv
hv
hv
ey
ey
ey
ey
ey
ey
ey
hv
hv
hv
hv
hv
hv
gC
gC
zJ
zJ
"}
(41,1,1) = {"
zJ
hv
rC
rC
rC
rC
Fm
ey
ey
ey
ey
ey
sU
hv
fg
fg
fg
hv
sU
ey
ey
ey
ey
ey
ey
ey
ey
ey
ey
ey
ey
Fm
rC
rC
rC
rC
hv
gC
gC
zJ
zJ
"}
(42,1,1) = {"
zJ
hv
rC
rC
rC
rC
hv
ey
ey
ey
ey
ey
ey
ey
ey
ey
ey
ey
ey
ey
ey
ey
ey
ey
ey
ey
ey
ey
ey
ey
ey
hv
rC
rC
rC
rC
hv
gC
gC
zJ
zJ
"}
(43,1,1) = {"
zJ
hv
rC
rC
rC
rC
hv
ey
ey
ey
ey
ey
ey
ey
ey
ey
ey
ey
ey
ey
ey
ey
ey
ey
ey
ey
ey
ey
ey
ey
ey
hv
rC
rC
rC
rC
hv
gC
gC
zJ
zJ
"}
(44,1,1) = {"
zJ
hv
rC
rC
rC
rC
hv
hv
hv
hv
hv
hv
hv
hv
hv
hv
hv
hv
hv
hv
hv
hv
hv
hv
hv
hv
hv
hv
hv
hv
hv
hv
rC
rC
rC
rC
hv
gC
gC
gC
zJ
"}
(45,1,1) = {"
zJ
hv
hv
hv
hv
hv
hv
gC
gC
gC
gC
gC
gC
gC
gC
gC
gC
gC
gC
gC
gC
gC
gC
gC
gC
gC
gC
gC
gC
gC
gC
hv
hv
hv
hv
hv
hv
gC
gC
gC
zJ
"}
(46,1,1) = {"
gC
gC
gC
gC
gC
gC
gC
gC
gC
gC
gC
gC
gC
gC
gC
zJ
zJ
zJ
zJ
zJ
zJ
zJ
zJ
zJ
zJ
zJ
zJ
zJ
zJ
zJ
zJ
gC
gC
gC
gC
gC
gC
gC
gC
gC
zJ
"}
